****************
*              *
* ****       ***
* *  * E       *
*    *         *
*    ******    *
*S             *
****************
